###################
#  ################
#                 #
# ##############  #
# #        ##@ # ##
# #      #   $ # ##
# #        ##  # ##
# #         #$ # ##
# #         #  # ##
# #        ##$ # ##
# #      #     # ##
#.#.       ##    ##
#.#############  ##
###################
