#########
#       #
#       #
## $# ###
##  # ###
## ##   #
#    @ .#
#  #    #
#  #    #
######### 
