##################
###############  #
#                #
#  ############# #
##            ## ##
##           $#.  #
##          @   # #
##           $#.  #
##            ## ##
#  ############# #
#                #
###############  #
##################
