#########
#       #
#       #
## $# ###
##  # ###
## ##   #
#  $ @ .#
#  #   .#
#  #    #
######### 
