##########
##      ##
## ## # ##
##  # # ##
###$$    #
#   ###$##
# # ##  .#
# # ## @.#
#       .#
##########
