##############
#        #####
# # # # ######
# # # # ######
#  $ $    *+.#
# # # # ######
# # # # ######
#        #####
##############
