#########
#       #
#       #
## $    #
##      #
##    @.#
#       #
#       #
#       #
######### 
