##########
##      ##
## ## # ##
##  # # ##
###$     #
#   ###$##
# # ##  .#
# # ## @##
#       .#
########## 
